1111111
1000C01
1000001
1P00C11
100E001
1111111