11111111111111
11110000000001
100C0000C00001
1C0000C0000001
11110000000001
100000P0000001
10C000C0000001
100000C0000001
1000C00000E001
11111111111111