1111111111111111111111111111111111111111111111111111111111111
1C00000000000000000000000000000000000000000000000000000000C01
1111111111111111000000000000000000000000000000000000000000001
1000000000000000000000000000000000000000000000000000000000011
10000000000000000000000000000000000000000000000000000000010C1
1000000000000000000000000000000000000000000000000000011111111
1000000000000000000000000000000000000000000000000000000000001
1000000000000000000C00000000000000000000000000000000000000001
100000000000000000000000000000000P000000000000000000000000001
10000000000000000000000000000000000000000000000000000000E0001
1000000000000000000000000000000000000000000000000000000000001
1000000000000000000000000000000000000000000000000000000000001
1000000000000000000000000000000000000000000000000000000000001
1000000000000000000C00000000000000000000000000000000000000001
1CC0000000000000000000000000000CCC000000000000000000000000C01
1111111111111111111111111111111111111111111111111111111111111