11111111111111111111111111111111111111
1C000000000000000000000000000000000001
10000000000000000000000000000000000001
10000000000000000000000000000000000001
10000000000000000000000000000000000011
10000000000000000000000000000000000001
1000000000000000000C000000000000000001
100000000000000000000000000000000P0001
10000000000000000000000000000000000E01
10000000000000000000000000000000000001
10000000000000000000000000000000000001
10000000000000000000000000000000000001
1000000000000000000C000000000000000001
1CC0000000000000000000000000000CC00001
11111111111111111111111111111111111111