11111111111111
11110000100001
100C0001C10001
1C0000C0000001
11110010000001
100001P1000001
10C00010000001
100000C0011101
1000C00000E101
11111111111111