111111
1C10E1
101101
10P0C1
111111