111111111111111111
10000PEC0001111111
100000000000000011
111111111111111111